11111111
10PC0001
10E00C01
11111111