1111111111111111111111111111111111
1000000000000000000000100000000001
1010000100100000101001100000010101
1010000010101010001000100000011111
1000P000000CC0000E0001100000010C01
1111111111111111111111111111111111
