1111111111111111111111111111111111
1000000000000000000000100000000001
1010000100100000101001100000010101
1010000010101010001001000000010101
1000P000000CC00000000100000E000001
1111111111111111111111111111111111
